##########
#        #
# ### ## #
# #    # #
# #  # # #
# ## #####
# #      #
# # #  # #
##### ####
#   #     
# #    # #
##########